##############
#...#.#.##...#
#.#...#..###.#
#.######...#.#
#....#...###.#
####.#.###...#
#....#...#.###
#.####.#.#.#.#
#.#....#.###.#
#.######...#.#
#........#...#
##############